S0110000001
0100111110
0100000010
0111111010
0000000010
0111111110
0100000000
0101111111
0100000001
0111111G01 